5 11 
###########
#...#P...B#
#A#.$.###*#
#...#D...R#  
###########
UURL
2 1 1 3 9
UULRDD

